a.m	a-raok meren
a.m.	a-raok meren
ao.	aotrou
Ao.	Aotrou
db.	diwar benn
dim.	Dimezell
Dim.	Dimezell
dwb	diwar benn
etc.	etc
g.m	goude meren
g.m.	goude meren
GM	goude meren
gt	gant
gt.	gant
gw.	gwelet
h.a.	hag all
it.	itron
It.	Itron
niv.	niverenn
Niv.	Niverenn
p.	pajenn
Pzd	Prezidant
sk.	skouer
s.o.	sellet ouzh
st	Sant
st.	Sant
St	Sant
St.	Sant
sz	Santez
sz.	Santez
Sz	Santez
Sz.	Santez
ub.	unan bennak
udb.	un dra bennak
