abardez	abardaez
ablamour	abalamour
aboae	abaoe
abominabl	abominapl
ac'hanoch	ac'hanoc'h
adkemmeret	adkemeret
adveñturioù	avanturioù
aeoc'h	aesoc'h
akademiez	akademiezh
alc'hwezh	alc'hwez
alkol	alkool
aluletez	alumetez
aluzenn	aluzen
aman	amañ
anezhan	anezhañ
anfeñ	enfin
añfin	enfin
ankou	Ankoù
anna	Anna
aotroù	aotrou
aozadennn	aozadenn
araok	a-raok
arbenigourien	arbennigourien
asae	esae
asañtiñ	asantiñ
atalerioù	atalieroù
avañtur	avantur
avañturioù	avanturioù
aventurioù	avanturioù
a-walch	a-walc'h
awalc'h	a-walc'h
awalch	a-walc'h
bammet	bamet
beljia	Belgia
bernn	benn
bezaén	bezañ
bezhinerien	bezhinaerien
bihañ	bihan
bihannoc'h	bihanoc'h
biniou	binioù
bizkoazh	biskoazh
bizness	business	
bleizh	bleiz
bloavez	bloavezh
bloavezioù	bloavezhioù
bloazh	bloaz
bonjour	boñjour
bouazhañ	boazhañ
bouetañ	boueta
bouetet	bouetaet
bourrabl	bourrapl
brehzoneg	brezhoneg
breiz	Breizh
brezhonegien	brezhonegerien
brezoneg	brezhoneg
broiou	broioù
buannoc'h	buanoc'h
bujet	budjed
bzh	BZH
c'hamarad	c'hamalad
c'hamaraded	c'hamaladed
c'hanada	C'hanada
c'helenerez	c'helennerez
cheller	c'heller
c'hellfer	c'hellfec'h
cheñchamañt	cheñchamant
chenchet	cheñchet
chêrioù	c'hêrioù
chifroù	sifroù
chigago	Chicago
c'hlenved	c'hleñved
choant	c'hoant
choant 	c'hoant 
choari	c'hoari
c'hoariou	c'hoarioù
c'hoarvezhout	c'hoarvezout
<c'hoarzh>	<C'HOARZH>
c'hoarzhiñ	c'hoarzhin
c'hoaz	c'hoazh
c'hoazhin	c'hoarzhin
c'homlec'h	chomlec'h
c'hotoz	c'hortoz
chouchen	chouchenn
choulz 	 c'houlz
c'houlzma	c'houlz ma
c'houzhout	c'houzout
c'hovid-19	C'hovid 19
c'hreizteiz	c'hreisteiz
c'hwevrer	C'hwevrer
chwi	c'hwi
c'oazh	c'hoazh
covid-19	Covid 19
c'whi	c'hwi
dangerus	dañjerus
danjer	dañjer
danjerus	dañjerus
danserien	dañserien
dansoù	dañsoù
dañvez	danvez
dañvezioù	danvezioù
daoù	daou
daouezek	daouzek
daouezk	daouezek
dd'ar	d'ar
deizoù	deizioù
deusoudon	deusouton
deuzouto	deusouto
devehzioù	devezhioù
dezhan	dezhañ
diaesamañtoù	diaezamantoù
diaezezet	diazezet
diagnostics	diagnostik
digouezhet	degouezhet
dihenchet	diheñchet
dilamour	dilabour
dilec'hiadennoù	dilerc'hiadennoù
dinozaored	dinosaored
diontañ	dioñtañ
dionte	dioñte
diorret	diorroet
diouzthu	diouzhtu
diposupl	dibosupl
dishenvel	disheñvel
dishenvel	disheñvel
dishoñjal	disoñjal
diskouezhet	diskouezet
dismegans	dismegañs
disonj	disoñj
divizioù	divizoù
divyehzeg	divyezhek
diwezhan	diwezhañ
dizhenvel	disheñvel
dlihad	dilhad
doareou	doareoù
donemad	donemat
doujans	doujañs
draezenn	drezenn
eamomp	emaomp
ebrel	Ebrel
ehzomm	ezhomm
einh	hein
eizhteiz	eizhtez
eizvedenn	eizhvedenn
ekspres	espres
electro	elektro
emannuel	Emmanuel
emcihañs	emichañs
emezan	emezañ
emomp	emaomp
emrenn	emren
emsalc'h	emzalc'h
enañ	ennañ
eñfeñ	enfin
enoet	enoeet
errout	erruout
esaet	aesaet
esktra	ekstra
espress	espres
etrezan	etrezañ
euriou	eurioù
europa	Europa
euros	euro
eurusamant	eüruzamant
eurüsamant	eüruzamant
eürusamant	eüruzamant
eurüs	eürus
euruzamant	eüruzamant
eveljust	evel-just
evideomp	evidomp
evitoc'h	evidoc'h
evt	evit
facebook	Facebook
fennoz	fenoz
formaj	fourmaj
founnus	fonnus
garom	garomp
gazezh	gazhez
gembre	Gembre
gemenadenn	gemennadenn
getan	getañ
giezh	giez
ginnnigas	ginnigas
gober	ober
google	Google
goulenet	goulennet
goulou	gouloù
graonienn	graoñenn
grenv	greñv
groc'henn	groc'hen
gulennet	goulennet
guntuilh	gutuilh
gwaneoc'h	ganeoc'h
gwann	gwan
gwasoc'h	gwashoc'h
gwazhañ	gwashañ
gwellet	gwelet
gwener	Gwener
gwengolo	Gwengolo
gwinnizh	gwinizh
gwiskat	gwiskad
hanterkant	hanter-kant
hanterkanvedenn	hanterkantvedenn
hanternozh	hanternoz
hardiz	hardizh
hegaziñ	hegasiñ
henchet	heñchet
hizio	hiziv
indianed	Indianed
indianez	Indianez
indonesia	Indonezia
intron	itron
ispisal	ispisial
justawalc'h	just a-walc'h
kaloneg	kalonek
kambodjia	Kambodja
kanved	kantved
kaondaonet	kondaonet
kaozadennoù	kaozeadennoù
kaozet	kaozeet
karezenn	karrezenn
kazimañt	kazimant
kelenerien	kelennerien
kelou	keloù
kemmeret	kemeret
kennebeud	kennebeut
kenneubeut	kennebeut
kenô	keno
klanv	klañv
kloaustre	klaoustre
kompetition	kompetision
kompetitionoù	kompetisionoù
konchennoù	koñchennoù
konfinet	koñfinet
konverzh	koñverzh
kool	cool
korea	Korea
kosoc'h	koshoc'h
koupladoù	koubladoù
kozhaat	koshaat
krampouzeh	krampouezh
kreizteiz	kreisteiz
kroc'henn	kroc'hen
lapoused	laboused
larvaret	lavaret
legumajoù	legumaj
lemet	lemmet
lenadenn	lennadenn
lenann	lennan
liammou	liammoù
llaer	laer
loiad	loaiad
lun	Lun
madalezhus	madelezhus
maestroniañ	mestroniañ
magreb	Maghreb
maleurüs	maleürus
mammenoù	mammennoù
marc'hatañ	marc'hata
marc'hatmatoc'h	marc'hadmatoc'h
marc'hhouarn	marc'h-houarn
marmoused	marmouzed
matalasenn	matarasenn
matalasennoù	matarasennoù
mec'hiko	Mec'hiko
mediaou	mediaoù
mennezhioù	menezioù
mennozioù	mennozhioù
menozh	mennozh
menoziou	mennozhioù
merc'her	Merc'her
meurzh	Meurzh
meus	m'eus
migoned	mignoned
migon	mignon
miliadou	miliadoù
mille 	mil
milliadou	miliadoù
milliadoù	miliadoù
milliardoù	miliardoù
million	milion
millionoù	milionoù
milouer	miloer
moneizh	moneiz
monneizh	moneiz
morbihan	Mor-bihan
mouezioù	mouezhioù
mousc'hoazh	mousc'hoarzh
mp3	MP3
musik	muzik
musique	muzik
naoned	Naoned
nebuet	nebeut
nedelek	Nedeleg
neizhañ	neizhiañ
nemetan	nemetañ
nemtken	nemetken
netaat	naetaat
neubeud	nebeud
neubeutoc'h	nebeutoc'h
neveshoc'h	nevesoc'h
nompass	nompas
oke	OK
ok	OK
oranjez	orañjez
orolajoù	horolajoù
otomatek	aotomatek
ouhzpenn	ouzhpenn
ouzphenn	ouzhpenn
pannelloù	panelloù
peanos	penaos
pemdezhiek	pemdezieg
pempzek	pemzek
pempzekvet	pemzekvet
peowgir	peogwir
personnel	personel
perunvan	peurunvan
perzhiou	perzhioù
peseut	peseurt
peurdesket	peurzesket
peurliseañ	peurliesañ
ploop	ploup
polikel	politikel
poltridi	poltriji
posubl	posupl
pouazhañ	poazhañ
pouezhusañ	pouezusañ
pouezhus	pouezus
renta-kont	rentañ-kont
renta-kont-se	rentañ-kont-se
roazhon	Roazhon
rouantelez	rouantelezh
salvedigezh	salvidigezh
santimañt	santimant
sañtimant	santimant
sañtimetrad	santimetrad
sañtimetr	santimetr
savetaeiñ	saveteiñ
seitekved	seitekvet
selaoù	selaou
sellaouit	selaouit
sellaou	selaou
sermonioù	sarmonioù
sertenamañt	sertenamant
siezhvet	seizhvet
skarzañ	skarzhañ
skinwell	skinwel
skolaerezh	skolaerez
skzuizh	skuizh
solkial	sokial
sonedagoù	sonadegoù
sonjal	soñjal
sonjet	soñjet
sonjit	soñjit
sonjoù	soñjoù
sonj	soñj
spouenn	spoueenn
stañk	stank
strategiezhioù	strategiezhoù
sul	Sul
surtoud	surtout
tailand	Thailand
taïland	Thailand
takennouigoù	takennoùigoù
taksi	taxi
talevzout	talvezout
talvoufdus	talvoudus
tangy	Tangi
taski	taxi
techout	tec'hout
teilh	teil
teknologezhioù	teknologiezhioù
tfunan	TF1
thaïland	Thailand
tonnenn	tonenn
toud	tout
traouigoù	traoùigoù
traou	traoù
treuskas	treuzkas
treuskrivet	treuzskrivet
triugentved	triugentvet
twitter	Twitter
ukrainia	Ukraina
ukrenia	Ukraina
unesco	UNESCO
unnan	unan
urzhiaterioù	urzhiataerioù
uzinioù	uzinoù
vaestronian	vestronian
vakansoù	vakañsoù
vestronia	vestroniañ
vidéoioù	videoioù
vigouden	Vigoudenn
vilajen	vilajenn
virgulen	virgulenn
vizkoazh	viskoazh
vizkoaz	viskoazh
vloazh	vloaz
vousc'hoarzin	vousc'hoarzhin
vousc'hoarz	vousc'hoarzh
vouzellen	vouzellenn
vretoned	Vretoned
vrummenn	vrumenn
waou	waouh
warc'hoarzh	warc'hoazh
warchoazh	warc'hoazh
warlerc'h	war lerc'h
warnan	warnañ
welled	welet
wellet	welet
wikipedia	Wikipedia
wikipédia	Wikipedia
woaw	waouh
www	WWW
yaou	Yaou
youtube	Youtube
ziar-benn	ziàr-benn
ziar	ziàr
ziskouezh	ziskouez
zrebimp	zebrimp
