

# Unvaniañ
#anezhe	anezho
#goût	gouzout
beljia	Belgia
breiz	Breizh
danemark	Danmark
dervezh	devezh
egipt	Ejipt
evid	evit
formaj	fourmaj
hirie	hiziv
hirio	hiziv
hiriv	hiziv
hounnezh	honnezh
japon	Japan
koa	kwa
moutik	moutig
plastek	plastik
poher	Poc'hêr
rostrenn	Rostren
russia	Rusia
stokholm	Stockholm
tailand	Thailand
taïland	Thailand
thaïland	Thailand
ty	ti
ukrainia	Ukraina
ukrenia	Ukraina
warlerc'h	war lerc'h
atao	atav



# Fr to Br,
# Those words sound the same in both language so we rewrite them to help the phonetizer
office	ofis
musique	muzik
télégramme	telegram



# Fazioù boutin
posubl	posupl
perzhiou	perzhioù
adkemmeret	adkemeret
aman	amañ
aotroù	aotrou
araok	a-raok
avañtur	avantur
awalc'h	a-walc'h
biniou	binioù
bourrabl	bourrapl
brezoneg	brezhoneg
chenchet	cheñchet
chigago	Chicago
choant 	c'hoant 
c'homlec'h	chomlec'h
choulz 	 c'houlz
dalc'hmad	dalc'hmat
dansoù	dañsoù
dañvez	danvez
dañvezioù	danvezioù
diagnostics	diagnostiks
diouzthu	diouzhtu
diposupl	dibosupl
dishenvel	disheñvel
dishenvel	disheñvel
dlihad	dilhad
doareou	doareoù
emsalc'h	emzalc'h
founnus	fonnus
goulou	gouloù
gouvezet	gouezet
grenv	greñv
gwann	gwan
jug	chug
kaozadennoù	kaozeadennoù
konchennoù	koñchennoù
laret	lâret
marc'hatmatoc'h	marc'hadmatoc'h
marmoused	marmouzed
memez	memes
mennozioù	menozioù
miliadou	miliadoù
milliadou	miliadoù
moneizh	moneiz
monneizh	moneiz
mouezioù	mouezhioù
neizhañ	neizhiañ
nozvat	noz vat
pannelloù	panelloù
personnel	personel
seitekved	seitekvet
siezhvet	seizhvet
stañk	stank
toud	tout
traouigoù	traoùigoù
treuskas	treuzkas
vakansoù	vakañsoù
vel	evel
vidon	evidon
vigouden	Vigoudenn
virgulen	virgulenn
vit	evit
vousc'hoarzin	vousc'hoarzhin
vousc'hoarz	vousc'hoarzh



# Fazioù Common voice
c'hoazhin	c'hoarzhin
million	milion
choari	c'hoari
bezaén	bezañ
hanterkanvedenn	hanterkantvedenn
brezhonek	brezhoneg
erwann	Erwan
nebuet	nebeut
france	Frañs
peseut	peseurt
vitale	vital
techout	tec'hout
ne reomp nemer sentiñ	ne reomp nemet sentiñ
er borioù pell	er broioù pell
aozadennn	aozadenn
emcihañs	emichañs
vrummenn	vrumenn
skinwell	skinwel
migon	mignon
taski	taksi
ecowatt	eko watt
c'houlzma	c'houlz ma
eo be tlakaet	eo bet lakaet
ao	aotrou
dim	dimezell
aeoc'h	aesoc'h
triugentved	triugentvet
maoc'h	emaoc'h
maomp	emaomp
penaoz	penaos
dilec'hiadennoù	dilerc'hiadennoù
ac'hanoch	ac'hanoc'h
c'whi	c'hwi
mille 	mil 
chwi	c'hwi
ar smic	ar SMIC
eit	evit
evt	evit
vbeethoven	Beethoven
skriviñ	skrivañ
warchoazh	warc'hoazh
llaer	laer
achu	echu
skzuizh	skuizh
bernn	benn
sonedagoù	sonadegoù
genoc'h	ganeoc'h
emezoc ’ h	emezoc'h
lenann	lenan
oar ke lenn	oar ket lenn
choant	c'hoant
R B I	RBI
gulennet	goulennet
klanv	klañv
enañ	ennañ
garom	garomp
neus	n'eus
meus	m'eus
M eus	m'eus
a rpaourkaezh	ar paourkaezh
½	hanter
Petr a	petra
I.V. 	itron Varia 
dwb	diwar benn
s.o. 	sellet ouzh 
Dime Square	*Dime *Square
Microsoft Corporation	Microsoft *Corporation
ar Mille-Clubs	ar *Mille *Clubs
Local Hero	*Local *Hero
enoet	enoeet
Alliance Française	*Alliance *Française
eizvedenn	eizhvedenn
aluletez	alumetez
dishoñjal	disoñjal
tonnenn	tonenn
kaondaonet	kondaonet
unnan	unan
c'houzhout	c'houzout
Outlook dija	*Outlook dija
a-bernn	a-benn
dd'ar	d'ar
e plis ar	e plij ar
diw wech	div wech
gwaneoc'h	ganeoc'h
dilhad sa sec'hañ	dilhad da sec'hañ
kentañ 'r bloaz	kentañ ar bloaz
hegaziñ	hegasiñ
hardiz	hardizh
No vo ket	ne vo ket
db.	diwar benn
gt Pzd	gant prezidant
dilamour	dilabour
brasenn	blasenn


# Anvioù
amélie	Ameli
argoat	Argoad
catherine	Katrin
christian	Kristian
christophe	Kristof
dominique	Dominig
émile	Emil
eric	Erik
fabrice	Fabris
frederig	Frederik
helena	Elena
hélène	Elen
helen	Elen
huelgoat	Uhelgoad
isabelle	Izabel
justine	Justin
kambodjia	Kambodja
loïc	Loig
maël	Mael
marcel	Marsel
maría	Maria
marianna	Mariana
marie	Mari
mélanie	Melani
normandie	Normandi
patrig	Padrig
philippe	Filip
plouescat	Ploueskad
plougastel	Plougastell
stéphan	Stefan
tanguy	Tangi
victoria	Viktoria
victor	Viktor
yannick	Yannig



 d' ar 	 d'ar 
 d' an 	 d'an 
 d' al 	 d'al 
 d' ur 	 d'ur 
 d' un 	 d'un 
 d' he 	 d'he 
 d' en 	 d'en 
 pa z 	 pa'z 
be'h	bec'h
#me 'm eus	me'm eus
 'm eus	 m'eus
 'm oa	 m'oa
'moa 	m'oa 
 'noa 	 n'oa 

bzh	BZH
www	WWW
fm	FM
m2	metrad karrez
cl	santilitr
ml	mililitr
cm	santimetr
km	kilometr
kg	kilogramm
kant g 	kant gramm 
c'hant g 	c'hant gramm 

II	daou
III	tri
IV	pevar
VI	c'hwec'h
VII	seizh
VIII	eizh
IX	nav
XVII	seizh
XIII	trizek

1añ	kentañ
IVe	pevare
Vvet	pempvet
VIvet	c'hwec'hvet
VIIvet	seizhvet
VIIIvet	eizhvet
IXvet	navet
Xvet	dekvet
XIIvet	daouzekvet
XVIIvet	seitekvet
XVIIIvet	triwec'hvet
XXvet	ugentvet

