?	àlkent
all	arall
atav	ataw
bemdez	bamdé
betek	betak, beteg
bevañ	beviñ
bezañ	bout
bloaz	blez
bremañ	bremen
c'hellfe	c'hellahe
c'hwi	hwi
defe	dehe
deiz	dé
deoc'h	deoh
dianv	dianav
din	dein
diouzh	doc'h
diskouez	diskoueziñ
diwar	diàr
ebet	erbet
eget	eged
erru	arru
evel	èl
evit	aveid, evid, eit
fonnus	fonnabl
ganeoc'h	genoc'h
ganin	genein, genin, getoñ
gant	get
gantañ	getañ
ganto	gete
goañv	gouiañv
gouezet	gouvezet
gouzout	gouiet
gwelet	guelet
hepken	hebkén
heñvel	hañval
hiziv	hiziw
holl	oll
istor	istoer
kelennerien	kelennerion
koulskoude	neoazh
kozh	koh
lakaat	lakaad
ma	mam, men
marteze	marsen
memes	memez
mont	moned, monet
n'ez	nend
nemet	nameit
o	é
oa	oe
ober	gober
oc'h	éc'h
pelec'h	menn
prezegennoù	predegennoù
skrivañ	skriviñ
vefent	vehent
vevañ	veviñ
vezañ	vout
vloaz	vlez
war	àr
warnezhe	àrnezhe
warni	àrni
