a bell	a-bell
a benn	a-benn
a berzh	a-berzh
a bezh	a-bezh
a blom	a-blom
a bouez	a-bouez
a dal	a-dal
a dehou	a-dehou
a drek	a-drek
a dreñv	a-dreñv
a dreuz	a-dreuz
a du	a-du
a enep	a-enep
a gleiz	a-gleiz
a hed	a-hed
a hend all	a-hend-all
a is	a-is
a oad	a-oad
a raok	a-raok
a ratozh	a-ratozh
a ratozh kaer	a-ratozh-kaer
a ribl	a-ribl
ar mogn	Ar Mogn
a sav	a-sav
a unan	a-unan
a us	a-us
a vent	a-vent
a walc'h	a-walc'h
a wechoù	a-wechoù
a wel	a-wel
a zehoù	a-zehoù
a zirak	a-zirak
a zivout	a-zivout
a ziwar	a-ziwar
barr avel	barr-avel
Breizh izel	Breizh-Izel
Breizh uhel	Breizh-Uhel
bro Dreger	Bro-Dreger
bro saoz	Bro Saoz
bro spagn	Bro Spagn
da heul	da-heul
daou ugent	daou-ugent
deomp ta	deomp 'ta
deuit ta	deuit 'ta
di embann	di-embann
din me	din-me
diwar benn	diwar-benn
dreist holl	dreist-holl
e barzh	e-barzh
e bleud	e-bleud
e giz	e-giz
e harz	e-harz
e keit	e-keit
e keñver	e-keñver
e kerz	e-kerzh
e kerzh	e-kerzh
e kichenn	e-kichenn
e kreiz	e-kreiz
e kreiz kêr	e kreiz-kêr
e kuzh	e-kuzh
e leizh	e-leizh
en dro	en-dro
e pad	e-pad
e tal	e-tal
e touez	e-touez
e unan	e-unan
evel henn	evel-henn
evel hont	evel-hont
evel just	evel-just
evel se	evel-se
fest noz	fest-noz
frañs tri	France 3
ger mell	ger-mell
goude merenn	goude-merenn
goude se	goude-se
hend all	a-hend-all
il ha Gwilen	Il-ha-Gwilen
jean françois	Jean-François
jean mari	Jean-Mari
jean pierre	Jean-Pierre
Kaledonia nevez	Kaledonia-Nevez
kemend all	kemend-all
Kerne veur	Kerne-Veur
kreiz kêr	kreiz-kêr
le fur	Le Fur
mamm gozh	mamm-gozh
marc'h du	marc'h-du
marc'h houarn	marc'h-houarn
master daou	Master 2
mat tre	mat-tre
miz du	miz Du
mor bihan	Mor-Bihan
muioc'h mui	muioc'h-mui
new York	New York
ouzhpenn se	ouzhpenn-se
penn ar bed	Penn-ar-Bed
pevar ugent	pevar-ugent
roazhon daou	Roazhon 2
rouantelezh unanet	Rouantelezh Unanet
sant maloù	Sant-Maloù
sant Nazer	Sant-Nazer
selaouit ta	selaouit 'ta
skol veur	skol-veur
stadoù unanet	Stadoù Unanet
su Afrikaned	Suafrikaned
su Azia	Su Azia
tad kozh	tad-kozh
tamm ha tamm	tamm-ha-tamm
tamm pe damm	tamm-pe-damm
ti embann	ti-embann
torr penn	torr-penn
tour tan	tour-tan
tri ugent	tri-ugent
tro dro	tro-dro
tro war dro	tro-war-dro
war c'horre	war-c'horre
war dro	war-dro
war lein	war-lein
war lerc'h	war-lerc'h
warn ugent	warn-ugent
war raok	war-raok
